2,2,2,2,2,2,2,2,2,2,2,2,2,2
2,2,2,2,2,2,2,2,2,2,2,2,2,2
2,2,2,2,2,2,2,2,2,2,2,2,2,2
2,2,2,2,2,2,2,2,2,2,2,2,2,2
2,2,2,2,2,2,2,2,2,4,4,2,2,2
2,2,2,2,2,2,2,2,2,4,4,2,2,2
2,2,2,2,2,2,2,2,2,4,4,2,2,2
0,0,0,0,0,0,0,0,0,0,0,0,0,0